subject,video,type,type_idx,startFrame,endFrame,frame_num,length,type_idx_minor
1,./CAS(ME)2_longVideoFaceCropped/longVideoFaceCropped/s15/15_0101disgustingteeth,macro-expression,1,1195,1266,2052,71,5
1,./CAS(ME)2_longVideoFaceCropped/longVideoFaceCropped/s15/15_0102eatingworms,macro-expression,1,396,430,1075,34,5
1,./CAS(ME)2_longVideoFaceCropped/longVideoFaceCropped/s15/15_0102eatingworms,macro-expression,1,407,435,1075,28,5
1,./CAS(ME)2_longVideoFaceCropped/longVideoFaceCropped/s15/15_0102eatingworms,macro-expression,1,781,802,1075,21,5
1,./CAS(ME)2_longVideoFaceCropped/longVideoFaceCropped/s15/15_0102eatingworms,micro-expression,2,699,707,1075,8,-1
1,./CAS(ME)2_longVideoFaceCropped/longVideoFaceCropped/s15/15_0401girlcrashing,macro-expression,1,557,608,3711,51,5
1,./CAS(ME)2_longVideoFaceCropped/longVideoFaceCropped/s15/15_0401girlcrashing,macro-expression,1,2854,2871,3711,17,-1
1,./CAS(ME)2_longVideoFaceCropped/longVideoFaceCropped/s15/15_0402beatingpregnantwoman,macro-expression,1,2155,2183,4370,28,5
1,./CAS(ME)2_longVideoFaceCropped/longVideoFaceCropped/s15/15_0402beatingpregnantwoman,macro-expression,1,3363,3383,4370,20,5
1,./CAS(ME)2_longVideoFaceCropped/longVideoFaceCropped/s15/15_0402beatingpregnantwoman,macro-expression,1,3380,3407,4370,27,5
1,./CAS(ME)2_longVideoFaceCropped/longVideoFaceCropped/s15/15_0402beatingpregnantwoman,macro-expression,1,3738,3822,4370,84,5
1,./CAS(ME)2_longVideoFaceCropped/longVideoFaceCropped/s15/15_0402beatingpregnantwoman,macro-expression,1,3761,3779,4370,18,5
1,./CAS(ME)2_longVideoFaceCropped/longVideoFaceCropped/s15/15_0502funnyerrors,macro-expression,1,178,210,2273,32,4
1,./CAS(ME)2_longVideoFaceCropped/longVideoFaceCropped/s15/15_0502funnyerrors,macro-expression,1,2203,2227,2273,24,4
1,./CAS(ME)2_longVideoFaceCropped/longVideoFaceCropped/s15/15_0502funnyerrors,micro-expression,2,138,148,2273,10,-1
1,./CAS(ME)2_longVideoFaceCropped/longVideoFaceCropped/s15/15_0503unnyfarting,macro-expression,1,2457,2510,2811,53,4
1,./CAS(ME)2_longVideoFaceCropped/longVideoFaceCropped/s15/15_0505funnyinnovations,macro-expression,1,1403,1436,2304,33,-1
2,./CAS(ME)2_longVideoFaceCropped/longVideoFaceCropped/s16/16_0101disgustingteeth,macro-expression,1,167,199,2051,32,5
2,./CAS(ME)2_longVideoFaceCropped/longVideoFaceCropped/s16/16_0101disgustingteeth,macro-expression,1,333,366,2051,33,5
2,./CAS(ME)2_longVideoFaceCropped/longVideoFaceCropped/s16/16_0101disgustingteeth,macro-expression,1,697,725,2051,28,5
2,./CAS(ME)2_longVideoFaceCropped/longVideoFaceCropped/s16/16_0101disgustingteeth,macro-expression,1,915,965,2051,50,5
2,./CAS(ME)2_longVideoFaceCropped/longVideoFaceCropped/s16/16_0101disgustingteeth,macro-expression,1,1228,1284,2051,56,5
2,./CAS(ME)2_longVideoFaceCropped/longVideoFaceCropped/s16/16_0101disgustingteeth,macro-expression,1,1792,1836,2051,44,5
2,./CAS(ME)2_longVideoFaceCropped/longVideoFaceCropped/s16/16_0101disgustingteeth,macro-expression,1,1794,1842,2051,48,5
2,./CAS(ME)2_longVideoFaceCropped/longVideoFaceCropped/s16/16_0101disgustingteeth,micro-expression,2,552,565,2051,13,3
2,./CAS(ME)2_longVideoFaceCropped/longVideoFaceCropped/s16/16_0102eatingworms,macro-expression,1,173,248,1075,75,-1
2,./CAS(ME)2_longVideoFaceCropped/longVideoFaceCropped/s16/16_0102eatingworms,macro-expression,1,187,240,1075,53,5
2,./CAS(ME)2_longVideoFaceCropped/longVideoFaceCropped/s16/16_0102eatingworms,macro-expression,1,317,400,1075,83,5
2,./CAS(ME)2_longVideoFaceCropped/longVideoFaceCropped/s16/16_0102eatingworms,macro-expression,1,322,356,1075,34,-1
2,./CAS(ME)2_longVideoFaceCropped/longVideoFaceCropped/s16/16_0102eatingworms,macro-expression,1,322,359,1075,37,-1
2,./CAS(ME)2_longVideoFaceCropped/longVideoFaceCropped/s16/16_0102eatingworms,macro-expression,1,420,445,1075,25,5
2,./CAS(ME)2_longVideoFaceCropped/longVideoFaceCropped/s16/16_0102eatingworms,macro-expression,1,526,543,1075,17,5
2,./CAS(ME)2_longVideoFaceCropped/longVideoFaceCropped/s16/16_0102eatingworms,macro-expression,1,720,741,1075,21,-1
2,./CAS(ME)2_longVideoFaceCropped/longVideoFaceCropped/s16/16_0102eatingworms,micro-expression,2,270,278,1075,8,2
2,./CAS(ME)2_longVideoFaceCropped/longVideoFaceCropped/s16/16_0401girlcrashing,macro-expression,1,554,617,3711,63,5
2,./CAS(ME)2_longVideoFaceCropped/longVideoFaceCropped/s16/16_0401girlcrashing,macro-expression,1,1656,1700,3711,44,5
2,./CAS(ME)2_longVideoFaceCropped/longVideoFaceCropped/s16/16_0401girlcrashing,macro-expression,1,1741,1780,3711,39,5
2,./CAS(ME)2_longVideoFaceCropped/longVideoFaceCropped/s16/16_0401girlcrashing,macro-expression,1,3580,3599,3711,19,5
2,./CAS(ME)2_longVideoFaceCropped/longVideoFaceCropped/s16/16_0402beatingpregnantwoman,macro-expression,1,415,457,4370,42,5
2,./CAS(ME)2_longVideoFaceCropped/longVideoFaceCropped/s16/16_0402beatingpregnantwoman,macro-expression,1,1382,1416,4370,34,5
2,./CAS(ME)2_longVideoFaceCropped/longVideoFaceCropped/s16/16_0402beatingpregnantwoman,macro-expression,1,1540,1577,4370,37,5
2,./CAS(ME)2_longVideoFaceCropped/longVideoFaceCropped/s16/16_0402beatingpregnantwoman,macro-expression,1,1865,1911,4370,46,5
2,./CAS(ME)2_longVideoFaceCropped/longVideoFaceCropped/s16/16_0402beatingpregnantwoman,macro-expression,1,2149,2210,4370,61,5
2,./CAS(ME)2_longVideoFaceCropped/longVideoFaceCropped/s16/16_0402beatingpregnantwoman,macro-expression,1,2712,2752,4370,40,-1
2,./CAS(ME)2_longVideoFaceCropped/longVideoFaceCropped/s16/16_0402beatingpregnantwoman,macro-expression,1,2905,2937,4370,32,5
2,./CAS(ME)2_longVideoFaceCropped/longVideoFaceCropped/s16/16_0402beatingpregnantwoman,macro-expression,1,3409,3461,4370,52,5
2,./CAS(ME)2_longVideoFaceCropped/longVideoFaceCropped/s16/16_0402beatingpregnantwoman,macro-expression,1,3932,3963,4370,31,5
2,./CAS(ME)2_longVideoFaceCropped/longVideoFaceCropped/s16/16_0502funnyerrors,macro-expression,1,338,373,2274,35,4
2,./CAS(ME)2_longVideoFaceCropped/longVideoFaceCropped/s16/16_0502funnyerrors,macro-expression,1,850,894,2274,44,5
2,./CAS(ME)2_longVideoFaceCropped/longVideoFaceCropped/s16/16_0502funnyerrors,macro-expression,1,1098,1148,2274,50,-1
2,./CAS(ME)2_longVideoFaceCropped/longVideoFaceCropped/s16/16_0502funnyerrors,macro-expression,1,1405,1441,2274,36,4
2,./CAS(ME)2_longVideoFaceCropped/longVideoFaceCropped/s16/16_0502funnyerrors,macro-expression,1,1470,1523,2274,53,-1
2,./CAS(ME)2_longVideoFaceCropped/longVideoFaceCropped/s16/16_0502funnyerrors,macro-expression,1,2193,2220,2274,27,-1
2,./CAS(ME)2_longVideoFaceCropped/longVideoFaceCropped/s16/16_0502funnyerrors,micro-expression,2,323,334,2274,11,3
2,./CAS(ME)2_longVideoFaceCropped/longVideoFaceCropped/s16/16_0505funnyinnovations,macro-expression,1,68,89,2303,21,4
2,./CAS(ME)2_longVideoFaceCropped/longVideoFaceCropped/s16/16_0505funnyinnovations,macro-expression,1,991,1017,2303,26,4
2,./CAS(ME)2_longVideoFaceCropped/longVideoFaceCropped/s16/16_0505funnyinnovations,macro-expression,1,1135,1205,2303,70,4
2,./CAS(ME)2_longVideoFaceCropped/longVideoFaceCropped/s16/16_0505funnyinnovations,macro-expression,1,1352,1388,2303,36,-1
2,./CAS(ME)2_longVideoFaceCropped/longVideoFaceCropped/s16/16_0505funnyinnovations,macro-expression,1,1595,1615,2303,20,-1
2,./CAS(ME)2_longVideoFaceCropped/longVideoFaceCropped/s16/16_0505funnyinnovations,macro-expression,1,1610,1678,2303,68,4
2,./CAS(ME)2_longVideoFaceCropped/longVideoFaceCropped/s16/16_0505funnyinnovations,macro-expression,1,1902,1952,2303,50,4
2,./CAS(ME)2_longVideoFaceCropped/longVideoFaceCropped/s16/16_0505funnyinnovations,macro-expression,1,2239,2295,2303,56,4
2,./CAS(ME)2_longVideoFaceCropped/longVideoFaceCropped/s16/16_0505funnyinnovations,micro-expression,2,396,407,2303,11,-1
2,./CAS(ME)2_longVideoFaceCropped/longVideoFaceCropped/s16/16_0505funnyinnovations,micro-expression,2,1695,1710,2303,15,-1
2,./CAS(ME)2_longVideoFaceCropped/longVideoFaceCropped/s16/16_0505funnyinnovations,micro-expression,2,1880,1895,2303,15,-1
2,./CAS(ME)2_longVideoFaceCropped/longVideoFaceCropped/s16/16_0507climbingthewall,macro-expression,1,844,870,3264,26,4
2,./CAS(ME)2_longVideoFaceCropped/longVideoFaceCropped/s16/16_0507climbingthewall,macro-expression,1,1571,1633,3264,62,4
2,./CAS(ME)2_longVideoFaceCropped/longVideoFaceCropped/s16/16_0507climbingthewall,macro-expression,1,2338,2411,3264,73,4
2,./CAS(ME)2_longVideoFaceCropped/longVideoFaceCropped/s16/16_0507climbingthewall,macro-expression,1,3169,3215,3264,46,4
2,./CAS(ME)2_longVideoFaceCropped/longVideoFaceCropped/s16/16_0507climbingthewall,micro-expression,2,1958,1968,3264,10,3
2,./CAS(ME)2_longVideoFaceCropped/longVideoFaceCropped/s16/16_0507climbingthewall,micro-expression,2,2285,2295,3264,10,1
3,./CAS(ME)2_longVideoFaceCropped/longVideoFaceCropped/s19/19_0102eatingworms,macro-expression,1,822,865,1070,43,-1
3,./CAS(ME)2_longVideoFaceCropped/longVideoFaceCropped/s19/19_0102eatingworms,macro-expression,1,887,926,1070,39,-1
3,./CAS(ME)2_longVideoFaceCropped/longVideoFaceCropped/s19/19_0402beatingpregnantwoman,micro-expression,2,1927,1942,4371,15,-1
3,./CAS(ME)2_longVideoFaceCropped/longVideoFaceCropped/s19/19_0505funnyinnovations,macro-expression,1,1755,1808,2304,53,4
3,./CAS(ME)2_longVideoFaceCropped/longVideoFaceCropped/s19/19_0507climbingthewall,macro-expression,1,2977,3039,3265,62,4
4,./CAS(ME)2_longVideoFaceCropped/longVideoFaceCropped/s20/20_0502funnyerrors,macro-expression,1,981,999,2274,18,4
4,./CAS(ME)2_longVideoFaceCropped/longVideoFaceCropped/s20/20_0502funnyerrors,macro-expression,1,1125,1161,2274,36,4
4,./CAS(ME)2_longVideoFaceCropped/longVideoFaceCropped/s20/20_0502funnyerrors,macro-expression,1,1403,1499,2274,96,4
5,./CAS(ME)2_longVideoFaceCropped/longVideoFaceCropped/s21/21_0101disgustingteeth,macro-expression,1,169,191,2053,22,-1
5,./CAS(ME)2_longVideoFaceCropped/longVideoFaceCropped/s21/21_0401girlcrashing,macro-expression,1,3379,3411,3716,32,5
6,./CAS(ME)2_longVideoFaceCropped/longVideoFaceCropped/s22/22_0101disgustingteeth,macro-expression,1,366,393,2052,27,5
6,./CAS(ME)2_longVideoFaceCropped/longVideoFaceCropped/s22/22_0101disgustingteeth,macro-expression,1,380,411,2052,31,-1
6,./CAS(ME)2_longVideoFaceCropped/longVideoFaceCropped/s22/22_0101disgustingteeth,macro-expression,1,510,545,2052,35,5
6,./CAS(ME)2_longVideoFaceCropped/longVideoFaceCropped/s22/22_0101disgustingteeth,macro-expression,1,1562,1580,2052,18,5
6,./CAS(ME)2_longVideoFaceCropped/longVideoFaceCropped/s22/22_0101disgustingteeth,macro-expression,1,1573,1598,2052,25,-1
6,./CAS(ME)2_longVideoFaceCropped/longVideoFaceCropped/s22/22_0101disgustingteeth,macro-expression,1,1645,1670,2052,25,5
6,./CAS(ME)2_longVideoFaceCropped/longVideoFaceCropped/s22/22_0101disgustingteeth,macro-expression,1,1706,1728,2052,22,-1
6,./CAS(ME)2_longVideoFaceCropped/longVideoFaceCropped/s22/22_0101disgustingteeth,macro-expression,1,1752,1768,2052,16,-1
6,./CAS(ME)2_longVideoFaceCropped/longVideoFaceCropped/s22/22_0101disgustingteeth,macro-expression,1,1822,1855,2052,33,-1
6,./CAS(ME)2_longVideoFaceCropped/longVideoFaceCropped/s22/22_0101disgustingteeth,macro-expression,1,1915,1941,2052,26,-1
6,./CAS(ME)2_longVideoFaceCropped/longVideoFaceCropped/s22/22_0102eatingworms,macro-expression,1,301,320,1072,19,5
6,./CAS(ME)2_longVideoFaceCropped/longVideoFaceCropped/s22/22_0102eatingworms,macro-expression,1,321,357,1072,36,-1
6,./CAS(ME)2_longVideoFaceCropped/longVideoFaceCropped/s22/22_0102eatingworms,macro-expression,1,904,932,1072,28,-1
6,./CAS(ME)2_longVideoFaceCropped/longVideoFaceCropped/s22/22_0402beatingpregnantwoman,macro-expression,1,3246,3290,4370,44,-1
6,./CAS(ME)2_longVideoFaceCropped/longVideoFaceCropped/s22/22_0503unnyfarting,macro-expression,1,2758,2794,2811,36,-1
6,./CAS(ME)2_longVideoFaceCropped/longVideoFaceCropped/s22/22_0508funnydunkey,macro-expression,1,81,135,659,54,4
7,./CAS(ME)2_longVideoFaceCropped/longVideoFaceCropped/s23/23_0102eatingworms,macro-expression,1,913,940,1071,27,-1
7,./CAS(ME)2_longVideoFaceCropped/longVideoFaceCropped/s23/23_0102eatingworms,macro-expression,1,997,1015,1071,18,-1
7,./CAS(ME)2_longVideoFaceCropped/longVideoFaceCropped/s23/23_0102eatingworms,micro-expression,2,331,346,1071,15,-1
7,./CAS(ME)2_longVideoFaceCropped/longVideoFaceCropped/s23/23_0102eatingworms,micro-expression,2,526,540,1071,14,-1
7,./CAS(ME)2_longVideoFaceCropped/longVideoFaceCropped/s23/23_0102eatingworms,micro-expression,2,727,740,1071,13,-1
7,./CAS(ME)2_longVideoFaceCropped/longVideoFaceCropped/s23/23_0402beatingpregnantwoman,macro-expression,1,3685,3719,4374,34,-1
7,./CAS(ME)2_longVideoFaceCropped/longVideoFaceCropped/s23/23_0402beatingpregnantwoman,macro-expression,1,3799,3818,4374,19,-1
7,./CAS(ME)2_longVideoFaceCropped/longVideoFaceCropped/s23/23_0402beatingpregnantwoman,macro-expression,1,3879,3903,4374,24,5
7,./CAS(ME)2_longVideoFaceCropped/longVideoFaceCropped/s23/23_0502funnyerrors,macro-expression,1,1381,1460,2273,79,-1
7,./CAS(ME)2_longVideoFaceCropped/longVideoFaceCropped/s23/23_0502funnyerrors,macro-expression,1,1937,1963,2273,26,-1
7,./CAS(ME)2_longVideoFaceCropped/longVideoFaceCropped/s23/23_0507climbingthewall,macro-expression,1,2744,2764,3265,20,4
8,./CAS(ME)2_longVideoFaceCropped/longVideoFaceCropped/s24/24_0101disgustingteeth,macro-expression,1,1356,1380,2052,24,5
8,./CAS(ME)2_longVideoFaceCropped/longVideoFaceCropped/s24/24_0101disgustingteeth,macro-expression,1,1383,1419,2052,36,5
8,./CAS(ME)2_longVideoFaceCropped/longVideoFaceCropped/s24/24_0401girlcrashing,macro-expression,1,355,385,3717,30,5
8,./CAS(ME)2_longVideoFaceCropped/longVideoFaceCropped/s24/24_0401girlcrashing,macro-expression,1,434,450,3717,16,5
8,./CAS(ME)2_longVideoFaceCropped/longVideoFaceCropped/s24/24_0401girlcrashing,macro-expression,1,1262,1289,3717,27,5
8,./CAS(ME)2_longVideoFaceCropped/longVideoFaceCropped/s24/24_0401girlcrashing,macro-expression,1,1903,1950,3717,47,5
8,./CAS(ME)2_longVideoFaceCropped/longVideoFaceCropped/s24/24_0401girlcrashing,macro-expression,1,2208,2276,3717,68,5
8,./CAS(ME)2_longVideoFaceCropped/longVideoFaceCropped/s24/24_0401girlcrashing,macro-expression,1,2543,2576,3717,33,5
8,./CAS(ME)2_longVideoFaceCropped/longVideoFaceCropped/s24/24_0401girlcrashing,macro-expression,1,3411,3440,3717,29,5
8,./CAS(ME)2_longVideoFaceCropped/longVideoFaceCropped/s24/24_0401girlcrashing,micro-expression,2,608,621,3717,13,-1
8,./CAS(ME)2_longVideoFaceCropped/longVideoFaceCropped/s24/24_0401girlcrashing,micro-expression,2,963,977,3717,14,2
8,./CAS(ME)2_longVideoFaceCropped/longVideoFaceCropped/s24/24_0401girlcrashing,micro-expression,2,1890,1902,3717,12,2
8,./CAS(ME)2_longVideoFaceCropped/longVideoFaceCropped/s24/24_0401girlcrashing,micro-expression,2,2181,2193,3717,12,2
8,./CAS(ME)2_longVideoFaceCropped/longVideoFaceCropped/s24/24_0401girlcrashing,micro-expression,2,3441,3453,3717,12,2
8,./CAS(ME)2_longVideoFaceCropped/longVideoFaceCropped/s24/24_0402beatingpregnantwoman,macro-expression,1,3297,3342,4371,45,5
8,./CAS(ME)2_longVideoFaceCropped/longVideoFaceCropped/s24/24_0402beatingpregnantwoman,macro-expression,1,3553,3599,4371,46,5
8,./CAS(ME)2_longVideoFaceCropped/longVideoFaceCropped/s24/24_0502funnyerrors,macro-expression,1,852,869,2273,17,4
8,./CAS(ME)2_longVideoFaceCropped/longVideoFaceCropped/s24/24_0502funnyerrors,macro-expression,1,1078,1101,2273,23,4
8,./CAS(ME)2_longVideoFaceCropped/longVideoFaceCropped/s24/24_0502funnyerrors,macro-expression,1,1584,1630,2273,46,4
8,./CAS(ME)2_longVideoFaceCropped/longVideoFaceCropped/s24/24_0502funnyerrors,macro-expression,1,1863,1889,2273,26,4
8,./CAS(ME)2_longVideoFaceCropped/longVideoFaceCropped/s24/24_0507climbingthewall,macro-expression,1,832,881,3265,49,4
8,./CAS(ME)2_longVideoFaceCropped/longVideoFaceCropped/s24/24_0507climbingthewall,macro-expression,1,1421,1464,3265,43,4
8,./CAS(ME)2_longVideoFaceCropped/longVideoFaceCropped/s24/24_0507climbingthewall,macro-expression,1,1648,1678,3265,30,6
8,./CAS(ME)2_longVideoFaceCropped/longVideoFaceCropped/s24/24_0507climbingthewall,macro-expression,1,1664,1703,3265,39,4
8,./CAS(ME)2_longVideoFaceCropped/longVideoFaceCropped/s24/24_0507climbingthewall,macro-expression,1,1858,1882,3265,24,4
8,./CAS(ME)2_longVideoFaceCropped/longVideoFaceCropped/s24/24_0507climbingthewall,macro-expression,1,2005,2044,3265,39,4
8,./CAS(ME)2_longVideoFaceCropped/longVideoFaceCropped/s24/24_0507climbingthewall,macro-expression,1,2229,2247,3265,18,5
8,./CAS(ME)2_longVideoFaceCropped/longVideoFaceCropped/s24/24_0507climbingthewall,macro-expression,1,2691,2746,3265,55,4
8,./CAS(ME)2_longVideoFaceCropped/longVideoFaceCropped/s24/24_0507climbingthewall,macro-expression,1,3168,3223,3265,55,4
8,./CAS(ME)2_longVideoFaceCropped/longVideoFaceCropped/s24/24_0507climbingthewall,micro-expression,2,1836,1848,3265,12,1
8,./CAS(ME)2_longVideoFaceCropped/longVideoFaceCropped/s24/24_0507climbingthewall,micro-expression,2,1951,1965,3265,14,3
8,./CAS(ME)2_longVideoFaceCropped/longVideoFaceCropped/s24/24_0507climbingthewall,micro-expression,2,3233,3248,3265,15,1
9,./CAS(ME)2_longVideoFaceCropped/longVideoFaceCropped/s25/25_0101disgustingteeth,micro-expression,2,113,127,2054,14,2
9,./CAS(ME)2_longVideoFaceCropped/longVideoFaceCropped/s25/25_0102eatingworms,macro-expression,1,470,490,1075,20,5
9,./CAS(ME)2_longVideoFaceCropped/longVideoFaceCropped/s25/25_0102eatingworms,micro-expression,2,996,1008,1075,12,2
9,./CAS(ME)2_longVideoFaceCropped/longVideoFaceCropped/s25/25_0102eatingworms,micro-expression,2,1008,1017,1075,9,2
9,./CAS(ME)2_longVideoFaceCropped/longVideoFaceCropped/s25/25_0102eatingworms,micro-expression,2,1018,1034,1075,16,2
9,./CAS(ME)2_longVideoFaceCropped/longVideoFaceCropped/s25/25_0502funnyerrors,macro-expression,1,841,913,2274,72,4
9,./CAS(ME)2_longVideoFaceCropped/longVideoFaceCropped/s25/25_0502funnyerrors,macro-expression,1,945,984,2274,39,4
9,./CAS(ME)2_longVideoFaceCropped/longVideoFaceCropped/s25/25_0508funnydunkey,macro-expression,1,123,167,660,44,4
9,./CAS(ME)2_longVideoFaceCropped/longVideoFaceCropped/s25/25_0508funnydunkey,macro-expression,1,189,223,660,34,4
10,./CAS(ME)2_longVideoFaceCropped/longVideoFaceCropped/s26/26_0101disgustingteeth,macro-expression,1,1014,1040,2052,26,-1
10,./CAS(ME)2_longVideoFaceCropped/longVideoFaceCropped/s26/26_0102eatingworms,macro-expression,1,308,345,1070,37,-1
10,./CAS(ME)2_longVideoFaceCropped/longVideoFaceCropped/s26/26_0102eatingworms,macro-expression,1,428,447,1070,19,-1
10,./CAS(ME)2_longVideoFaceCropped/longVideoFaceCropped/s26/26_0401girlcrashing,macro-expression,1,575,622,3714,47,-1
10,./CAS(ME)2_longVideoFaceCropped/longVideoFaceCropped/s26/26_0503unnyfarting,macro-expression,1,408,458,2811,50,5
10,./CAS(ME)2_longVideoFaceCropped/longVideoFaceCropped/s26/26_0503unnyfarting,macro-expression,1,1727,1757,2811,30,5
11,./CAS(ME)2_longVideoFaceCropped/longVideoFaceCropped/s27/27_0101disgustingteeth,macro-expression,1,417,473,2052,56,5
11,./CAS(ME)2_longVideoFaceCropped/longVideoFaceCropped/s27/27_0101disgustingteeth,macro-expression,1,890,911,2052,21,5
11,./CAS(ME)2_longVideoFaceCropped/longVideoFaceCropped/s27/27_0101disgustingteeth,macro-expression,1,1201,1220,2052,19,5
11,./CAS(ME)2_longVideoFaceCropped/longVideoFaceCropped/s27/27_0101disgustingteeth,macro-expression,1,1221,1250,2052,29,5
11,./CAS(ME)2_longVideoFaceCropped/longVideoFaceCropped/s27/27_0101disgustingteeth,macro-expression,1,1703,1722,2052,19,-1
11,./CAS(ME)2_longVideoFaceCropped/longVideoFaceCropped/s27/27_0101disgustingteeth,micro-expression,2,874,888,2052,14,2
11,./CAS(ME)2_longVideoFaceCropped/longVideoFaceCropped/s27/27_0102eatingworms,macro-expression,1,314,332,1076,18,5
11,./CAS(ME)2_longVideoFaceCropped/longVideoFaceCropped/s27/27_0102eatingworms,macro-expression,1,439,457,1076,18,5
11,./CAS(ME)2_longVideoFaceCropped/longVideoFaceCropped/s27/27_0102eatingworms,macro-expression,1,452,509,1076,57,5
11,./CAS(ME)2_longVideoFaceCropped/longVideoFaceCropped/s27/27_0102eatingworms,macro-expression,1,553,572,1076,19,5
11,./CAS(ME)2_longVideoFaceCropped/longVideoFaceCropped/s27/27_0102eatingworms,macro-expression,1,795,818,1076,23,5
11,./CAS(ME)2_longVideoFaceCropped/longVideoFaceCropped/s27/27_0102eatingworms,macro-expression,1,1053,1074,1076,21,-1
11,./CAS(ME)2_longVideoFaceCropped/longVideoFaceCropped/s27/27_0102eatingworms,micro-expression,2,34,48,1076,14,-1
11,./CAS(ME)2_longVideoFaceCropped/longVideoFaceCropped/s27/27_0102eatingworms,micro-expression,2,309,317,1076,8,2
11,./CAS(ME)2_longVideoFaceCropped/longVideoFaceCropped/s27/27_0102eatingworms,micro-expression,2,374,388,1076,14,2
11,./CAS(ME)2_longVideoFaceCropped/longVideoFaceCropped/s27/27_0401girlcrashing,macro-expression,1,1152,1177,3712,25,5
11,./CAS(ME)2_longVideoFaceCropped/longVideoFaceCropped/s27/27_0401girlcrashing,macro-expression,1,1682,1733,3712,51,5
11,./CAS(ME)2_longVideoFaceCropped/longVideoFaceCropped/s27/27_0401girlcrashing,macro-expression,1,2158,2182,3712,24,5
11,./CAS(ME)2_longVideoFaceCropped/longVideoFaceCropped/s27/27_0401girlcrashing,macro-expression,1,2241,2258,3712,17,5
11,./CAS(ME)2_longVideoFaceCropped/longVideoFaceCropped/s27/27_0401girlcrashing,micro-expression,2,352,365,3712,13,2
11,./CAS(ME)2_longVideoFaceCropped/longVideoFaceCropped/s27/27_0401girlcrashing,micro-expression,2,369,382,3712,13,2
11,./CAS(ME)2_longVideoFaceCropped/longVideoFaceCropped/s27/27_0401girlcrashing,micro-expression,2,1135,1147,3712,12,2
11,./CAS(ME)2_longVideoFaceCropped/longVideoFaceCropped/s27/27_0401girlcrashing,micro-expression,2,1974,1986,3712,12,2
11,./CAS(ME)2_longVideoFaceCropped/longVideoFaceCropped/s27/27_0402beatingpregnantwoman,macro-expression,1,2632,2653,4371,21,5
11,./CAS(ME)2_longVideoFaceCropped/longVideoFaceCropped/s27/27_0402beatingpregnantwoman,macro-expression,1,3727,3745,4371,18,5
11,./CAS(ME)2_longVideoFaceCropped/longVideoFaceCropped/s27/27_0502funnyerrors,macro-expression,1,169,251,2273,82,4
11,./CAS(ME)2_longVideoFaceCropped/longVideoFaceCropped/s27/27_0502funnyerrors,macro-expression,1,329,361,2273,32,4
11,./CAS(ME)2_longVideoFaceCropped/longVideoFaceCropped/s27/27_0502funnyerrors,macro-expression,1,558,599,2273,41,4
11,./CAS(ME)2_longVideoFaceCropped/longVideoFaceCropped/s27/27_0502funnyerrors,macro-expression,1,1081,1133,2273,52,4
11,./CAS(ME)2_longVideoFaceCropped/longVideoFaceCropped/s27/27_0502funnyerrors,macro-expression,1,1438,1465,2273,27,-1
11,./CAS(ME)2_longVideoFaceCropped/longVideoFaceCropped/s27/27_0502funnyerrors,macro-expression,1,2187,2219,2273,32,4
11,./CAS(ME)2_longVideoFaceCropped/longVideoFaceCropped/s27/27_0502funnyerrors,micro-expression,2,613,628,2273,15,1
11,./CAS(ME)2_longVideoFaceCropped/longVideoFaceCropped/s27/27_0503unnyfarting,macro-expression,1,359,394,2810,35,4
11,./CAS(ME)2_longVideoFaceCropped/longVideoFaceCropped/s27/27_0503unnyfarting,macro-expression,1,2225,2271,2810,46,4
11,./CAS(ME)2_longVideoFaceCropped/longVideoFaceCropped/s27/27_0503unnyfarting,micro-expression,2,419,432,2810,13,1
11,./CAS(ME)2_longVideoFaceCropped/longVideoFaceCropped/s27/27_0505funnyinnovations,macro-expression,1,1122,1234,2304,112,4
11,./CAS(ME)2_longVideoFaceCropped/longVideoFaceCropped/s27/27_0505funnyinnovations,macro-expression,1,1758,1813,2304,55,4
11,./CAS(ME)2_longVideoFaceCropped/longVideoFaceCropped/s27/27_0505funnyinnovations,macro-expression,1,1918,1982,2304,64,4
11,./CAS(ME)2_longVideoFaceCropped/longVideoFaceCropped/s27/27_0507climbingthewall,macro-expression,1,901,919,3265,18,5
11,./CAS(ME)2_longVideoFaceCropped/longVideoFaceCropped/s27/27_0507climbingthewall,macro-expression,1,2677,2702,3265,25,6
11,./CAS(ME)2_longVideoFaceCropped/longVideoFaceCropped/s27/27_0507climbingthewall,macro-expression,1,3187,3212,3265,25,4
11,./CAS(ME)2_longVideoFaceCropped/longVideoFaceCropped/s27/27_0507climbingthewall,micro-expression,2,876,890,3265,14,-1
11,./CAS(ME)2_longVideoFaceCropped/longVideoFaceCropped/s27/27_0508funnydunkey,macro-expression,1,179,243,660,64,4
12,./CAS(ME)2_longVideoFaceCropped/longVideoFaceCropped/s29/29_0502funnyerrors,micro-expression,2,140,152,2275,12,-1
13,./CAS(ME)2_longVideoFaceCropped/longVideoFaceCropped/s30/30_0101disgustingteeth,micro-expression,2,1455,1466,2051,11,-1
13,./CAS(ME)2_longVideoFaceCropped/longVideoFaceCropped/s30/30_0102eatingworms,macro-expression,1,337,385,1069,48,-1
13,./CAS(ME)2_longVideoFaceCropped/longVideoFaceCropped/s30/30_0102eatingworms,macro-expression,1,761,804,1069,43,-1
13,./CAS(ME)2_longVideoFaceCropped/longVideoFaceCropped/s30/30_0401girlcrashing,macro-expression,1,395,422,3716,27,5
13,./CAS(ME)2_longVideoFaceCropped/longVideoFaceCropped/s30/30_0401girlcrashing,macro-expression,1,1581,1622,3716,41,-1
13,./CAS(ME)2_longVideoFaceCropped/longVideoFaceCropped/s30/30_0401girlcrashing,macro-expression,1,2983,3021,3716,38,-1
13,./CAS(ME)2_longVideoFaceCropped/longVideoFaceCropped/s30/30_0401girlcrashing,micro-expression,2,926,941,3716,15,-1
13,./CAS(ME)2_longVideoFaceCropped/longVideoFaceCropped/s30/30_0502funnyerrors,macro-expression,1,167,197,2274,30,4
13,./CAS(ME)2_longVideoFaceCropped/longVideoFaceCropped/s30/30_0502funnyerrors,macro-expression,1,331,410,2274,79,4
13,./CAS(ME)2_longVideoFaceCropped/longVideoFaceCropped/s30/30_0502funnyerrors,macro-expression,1,846,895,2274,49,4
13,./CAS(ME)2_longVideoFaceCropped/longVideoFaceCropped/s30/30_0502funnyerrors,macro-expression,1,1172,1215,2274,43,4
13,./CAS(ME)2_longVideoFaceCropped/longVideoFaceCropped/s30/30_0502funnyerrors,macro-expression,1,1569,1614,2274,45,4
13,./CAS(ME)2_longVideoFaceCropped/longVideoFaceCropped/s30/30_0502funnyerrors,macro-expression,1,1918,1954,2274,36,4
13,./CAS(ME)2_longVideoFaceCropped/longVideoFaceCropped/s30/30_0503unnyfarting,macro-expression,1,1419,1458,2810,39,4
13,./CAS(ME)2_longVideoFaceCropped/longVideoFaceCropped/s30/30_0503unnyfarting,macro-expression,1,1547,1582,2810,35,4
13,./CAS(ME)2_longVideoFaceCropped/longVideoFaceCropped/s30/30_0505funnyinnovations,macro-expression,1,1141,1186,2303,45,4
13,./CAS(ME)2_longVideoFaceCropped/longVideoFaceCropped/s30/30_0505funnyinnovations,macro-expression,1,2232,2302,2303,70,4
13,./CAS(ME)2_longVideoFaceCropped/longVideoFaceCropped/s30/30_0507climbingthewall,macro-expression,1,1680,1698,3264,18,4
13,./CAS(ME)2_longVideoFaceCropped/longVideoFaceCropped/s30/30_0507climbingthewall,macro-expression,1,3179,3213,3264,34,4
14,./CAS(ME)2_longVideoFaceCropped/longVideoFaceCropped/s31/31_0101disgustingteeth,macro-expression,1,382,457,2051,75,-1
14,./CAS(ME)2_longVideoFaceCropped/longVideoFaceCropped/s31/31_0101disgustingteeth,macro-expression,1,555,611,2051,56,-1
14,./CAS(ME)2_longVideoFaceCropped/longVideoFaceCropped/s31/31_0101disgustingteeth,macro-expression,1,726,843,2051,117,-1
14,./CAS(ME)2_longVideoFaceCropped/longVideoFaceCropped/s31/31_0101disgustingteeth,macro-expression,1,836,886,2051,50,6
14,./CAS(ME)2_longVideoFaceCropped/longVideoFaceCropped/s31/31_0101disgustingteeth,macro-expression,1,1089,1140,2051,51,-1
14,./CAS(ME)2_longVideoFaceCropped/longVideoFaceCropped/s31/31_0101disgustingteeth,macro-expression,1,1150,1169,2051,19,6
14,./CAS(ME)2_longVideoFaceCropped/longVideoFaceCropped/s31/31_0101disgustingteeth,macro-expression,1,1561,1601,2051,40,5
14,./CAS(ME)2_longVideoFaceCropped/longVideoFaceCropped/s31/31_0101disgustingteeth,macro-expression,1,1631,1660,2051,29,-1
14,./CAS(ME)2_longVideoFaceCropped/longVideoFaceCropped/s31/31_0101disgustingteeth,micro-expression,2,1421,1433,2051,12,-1
14,./CAS(ME)2_longVideoFaceCropped/longVideoFaceCropped/s31/31_0401girlcrashing,macro-expression,1,515,534,3712,19,6
14,./CAS(ME)2_longVideoFaceCropped/longVideoFaceCropped/s31/31_0401girlcrashing,macro-expression,1,2850,2876,3712,26,6
14,./CAS(ME)2_longVideoFaceCropped/longVideoFaceCropped/s31/31_0401girlcrashing,macro-expression,1,3337,3383,3712,46,-1
14,./CAS(ME)2_longVideoFaceCropped/longVideoFaceCropped/s31/31_0402beatingpregnantwoman,macro-expression,1,863,888,4371,25,5
14,./CAS(ME)2_longVideoFaceCropped/longVideoFaceCropped/s31/31_0402beatingpregnantwoman,macro-expression,1,2123,2156,4371,33,6
14,./CAS(ME)2_longVideoFaceCropped/longVideoFaceCropped/s31/31_0402beatingpregnantwoman,macro-expression,1,2205,2226,4371,21,-1
14,./CAS(ME)2_longVideoFaceCropped/longVideoFaceCropped/s31/31_0402beatingpregnantwoman,macro-expression,1,2395,2450,4371,55,6
14,./CAS(ME)2_longVideoFaceCropped/longVideoFaceCropped/s31/31_0402beatingpregnantwoman,macro-expression,1,3277,3351,4371,74,6
14,./CAS(ME)2_longVideoFaceCropped/longVideoFaceCropped/s31/31_0402beatingpregnantwoman,macro-expression,1,3479,3509,4371,30,6
14,./CAS(ME)2_longVideoFaceCropped/longVideoFaceCropped/s31/31_0402beatingpregnantwoman,micro-expression,2,1689,1702,4371,13,-1
14,./CAS(ME)2_longVideoFaceCropped/longVideoFaceCropped/s31/31_0402beatingpregnantwoman,micro-expression,2,2190,2204,4371,14,3
14,./CAS(ME)2_longVideoFaceCropped/longVideoFaceCropped/s31/31_0402beatingpregnantwoman,micro-expression,2,2377,2389,4371,12,3
14,./CAS(ME)2_longVideoFaceCropped/longVideoFaceCropped/s31/31_0402beatingpregnantwoman,micro-expression,2,3803,3815,4371,12,-1
14,./CAS(ME)2_longVideoFaceCropped/longVideoFaceCropped/s31/31_0502funnyerrors,macro-expression,1,1595,1653,2273,58,-1
14,./CAS(ME)2_longVideoFaceCropped/longVideoFaceCropped/s31/31_0503unnyfarting,macro-expression,1,2169,2223,2810,54,-1
14,./CAS(ME)2_longVideoFaceCropped/longVideoFaceCropped/s31/31_0505funnyinnovations,macro-expression,1,2242,2279,2303,37,4
14,./CAS(ME)2_longVideoFaceCropped/longVideoFaceCropped/s31/31_0505funnyinnovations,micro-expression,2,1046,1059,2303,13,-1
14,./CAS(ME)2_longVideoFaceCropped/longVideoFaceCropped/s31/31_0507climbingthewall,macro-expression,1,768,793,3265,25,5
14,./CAS(ME)2_longVideoFaceCropped/longVideoFaceCropped/s31/31_0507climbingthewall,macro-expression,1,834,857,3265,23,6
14,./CAS(ME)2_longVideoFaceCropped/longVideoFaceCropped/s31/31_0507climbingthewall,macro-expression,1,1500,1540,3265,40,6
14,./CAS(ME)2_longVideoFaceCropped/longVideoFaceCropped/s31/31_0507climbingthewall,macro-expression,1,1565,1586,3265,21,6
14,./CAS(ME)2_longVideoFaceCropped/longVideoFaceCropped/s31/31_0507climbingthewall,macro-expression,1,2247,2288,3265,41,6
14,./CAS(ME)2_longVideoFaceCropped/longVideoFaceCropped/s31/31_0507climbingthewall,macro-expression,1,3114,3144,3265,30,-1
15,./CAS(ME)2_longVideoFaceCropped/longVideoFaceCropped/s32/32_0101disgustingteeth,macro-expression,1,885,919,2053,34,-1
15,./CAS(ME)2_longVideoFaceCropped/longVideoFaceCropped/s32/32_0101disgustingteeth,macro-expression,1,1234,1250,2053,16,5
15,./CAS(ME)2_longVideoFaceCropped/longVideoFaceCropped/s32/32_0102eatingworms,macro-expression,1,780,802,1071,22,5
15,./CAS(ME)2_longVideoFaceCropped/longVideoFaceCropped/s32/32_0401girlcrashing,macro-expression,1,302,322,3717,20,5
15,./CAS(ME)2_longVideoFaceCropped/longVideoFaceCropped/s32/32_0401girlcrashing,macro-expression,1,344,360,3717,16,5
15,./CAS(ME)2_longVideoFaceCropped/longVideoFaceCropped/s32/32_0401girlcrashing,macro-expression,1,406,439,3717,33,5
15,./CAS(ME)2_longVideoFaceCropped/longVideoFaceCropped/s32/32_0401girlcrashing,macro-expression,1,562,609,3717,47,5
15,./CAS(ME)2_longVideoFaceCropped/longVideoFaceCropped/s32/32_0401girlcrashing,macro-expression,1,874,897,3717,23,5
15,./CAS(ME)2_longVideoFaceCropped/longVideoFaceCropped/s32/32_0401girlcrashing,macro-expression,1,1310,1363,3717,53,5
15,./CAS(ME)2_longVideoFaceCropped/longVideoFaceCropped/s32/32_0401girlcrashing,macro-expression,1,1518,1560,3717,42,5
15,./CAS(ME)2_longVideoFaceCropped/longVideoFaceCropped/s32/32_0401girlcrashing,macro-expression,1,1650,1674,3717,24,5
15,./CAS(ME)2_longVideoFaceCropped/longVideoFaceCropped/s32/32_0401girlcrashing,macro-expression,1,1692,1742,3717,50,5
15,./CAS(ME)2_longVideoFaceCropped/longVideoFaceCropped/s32/32_0401girlcrashing,macro-expression,1,2249,2335,3717,86,5
15,./CAS(ME)2_longVideoFaceCropped/longVideoFaceCropped/s32/32_0401girlcrashing,macro-expression,1,2407,2475,3717,68,-1
15,./CAS(ME)2_longVideoFaceCropped/longVideoFaceCropped/s32/32_0401girlcrashing,macro-expression,1,2796,2845,3717,49,-1
15,./CAS(ME)2_longVideoFaceCropped/longVideoFaceCropped/s32/32_0401girlcrashing,macro-expression,1,2912,2961,3717,49,5
15,./CAS(ME)2_longVideoFaceCropped/longVideoFaceCropped/s32/32_0401girlcrashing,macro-expression,1,3173,3197,3717,24,5
15,./CAS(ME)2_longVideoFaceCropped/longVideoFaceCropped/s32/32_0401girlcrashing,micro-expression,2,268,278,3717,10,2
15,./CAS(ME)2_longVideoFaceCropped/longVideoFaceCropped/s32/32_0402beatingpregnantwoman,macro-expression,1,1531,1550,4374,19,5
15,./CAS(ME)2_longVideoFaceCropped/longVideoFaceCropped/s32/32_0402beatingpregnantwoman,macro-expression,1,2270,2295,4374,25,5
15,./CAS(ME)2_longVideoFaceCropped/longVideoFaceCropped/s32/32_0402beatingpregnantwoman,macro-expression,1,2774,2802,4374,28,5
15,./CAS(ME)2_longVideoFaceCropped/longVideoFaceCropped/s32/32_0402beatingpregnantwoman,macro-expression,1,3200,3230,4374,30,5
15,./CAS(ME)2_longVideoFaceCropped/longVideoFaceCropped/s32/32_0402beatingpregnantwoman,macro-expression,1,3396,3426,4374,30,5
15,./CAS(ME)2_longVideoFaceCropped/longVideoFaceCropped/s32/32_0402beatingpregnantwoman,macro-expression,1,3745,3807,4374,62,5
15,./CAS(ME)2_longVideoFaceCropped/longVideoFaceCropped/s32/32_0402beatingpregnantwoman,macro-expression,1,3999,4073,4374,74,5
15,./CAS(ME)2_longVideoFaceCropped/longVideoFaceCropped/s32/32_0502funnyerrors,macro-expression,1,139,194,2274,55,6
15,./CAS(ME)2_longVideoFaceCropped/longVideoFaceCropped/s32/32_0502funnyerrors,macro-expression,1,325,345,2274,20,6
15,./CAS(ME)2_longVideoFaceCropped/longVideoFaceCropped/s32/32_0502funnyerrors,macro-expression,1,404,430,2274,26,4
15,./CAS(ME)2_longVideoFaceCropped/longVideoFaceCropped/s32/32_0502funnyerrors,macro-expression,1,858,909,2274,51,4
15,./CAS(ME)2_longVideoFaceCropped/longVideoFaceCropped/s32/32_0502funnyerrors,macro-expression,1,1570,1609,2274,39,4
15,./CAS(ME)2_longVideoFaceCropped/longVideoFaceCropped/s32/32_0502funnyerrors,macro-expression,1,2203,2229,2274,26,4
15,./CAS(ME)2_longVideoFaceCropped/longVideoFaceCropped/s32/32_0502funnyerrors,micro-expression,2,311,324,2274,13,3
15,./CAS(ME)2_longVideoFaceCropped/longVideoFaceCropped/s32/32_0502funnyerrors,micro-expression,2,1171,1184,2274,13,3
15,./CAS(ME)2_longVideoFaceCropped/longVideoFaceCropped/s32/32_0503unnyfarting,macro-expression,1,258,319,2811,61,4
15,./CAS(ME)2_longVideoFaceCropped/longVideoFaceCropped/s32/32_0503unnyfarting,macro-expression,1,349,416,2811,67,4
15,./CAS(ME)2_longVideoFaceCropped/longVideoFaceCropped/s32/32_0503unnyfarting,macro-expression,1,656,716,2811,60,4
15,./CAS(ME)2_longVideoFaceCropped/longVideoFaceCropped/s32/32_0503unnyfarting,macro-expression,1,729,755,2811,26,4
15,./CAS(ME)2_longVideoFaceCropped/longVideoFaceCropped/s32/32_0503unnyfarting,macro-expression,1,748,820,2811,72,4
15,./CAS(ME)2_longVideoFaceCropped/longVideoFaceCropped/s32/32_0503unnyfarting,macro-expression,1,1082,1143,2811,61,4
15,./CAS(ME)2_longVideoFaceCropped/longVideoFaceCropped/s32/32_0503unnyfarting,macro-expression,1,1552,1586,2811,34,4
15,./CAS(ME)2_longVideoFaceCropped/longVideoFaceCropped/s32/32_0503unnyfarting,macro-expression,1,1559,1611,2811,52,4
15,./CAS(ME)2_longVideoFaceCropped/longVideoFaceCropped/s32/32_0503unnyfarting,macro-expression,1,1751,1780,2811,29,4
15,./CAS(ME)2_longVideoFaceCropped/longVideoFaceCropped/s32/32_0503unnyfarting,macro-expression,1,2077,2132,2811,55,4
15,./CAS(ME)2_longVideoFaceCropped/longVideoFaceCropped/s32/32_0503unnyfarting,macro-expression,1,2454,2500,2811,46,4
15,./CAS(ME)2_longVideoFaceCropped/longVideoFaceCropped/s32/32_0503unnyfarting,macro-expression,1,2663,2728,2811,65,4
15,./CAS(ME)2_longVideoFaceCropped/longVideoFaceCropped/s32/32_0503unnyfarting,micro-expression,2,258,272,2811,14,1
15,./CAS(ME)2_longVideoFaceCropped/longVideoFaceCropped/s32/32_0503unnyfarting,micro-expression,2,1031,1044,2811,13,2
15,./CAS(ME)2_longVideoFaceCropped/longVideoFaceCropped/s32/32_0505funnyinnovations,macro-expression,1,1362,1380,2304,18,5
15,./CAS(ME)2_longVideoFaceCropped/longVideoFaceCropped/s32/32_0505funnyinnovations,macro-expression,1,1382,1405,2304,23,5
15,./CAS(ME)2_longVideoFaceCropped/longVideoFaceCropped/s32/32_0505funnyinnovations,macro-expression,1,1709,1750,2304,41,4
15,./CAS(ME)2_longVideoFaceCropped/longVideoFaceCropped/s32/32_0505funnyinnovations,macro-expression,1,2212,2272,2304,60,4
15,./CAS(ME)2_longVideoFaceCropped/longVideoFaceCropped/s32/32_0507climbingthewall,macro-expression,1,1646,1743,3265,97,4
15,./CAS(ME)2_longVideoFaceCropped/longVideoFaceCropped/s32/32_0507climbingthewall,macro-expression,1,2332,2348,3265,16,4
15,./CAS(ME)2_longVideoFaceCropped/longVideoFaceCropped/s32/32_0508funnydunkey,micro-expression,2,286,301,660,15,2
16,./CAS(ME)2_longVideoFaceCropped/longVideoFaceCropped/s33/33_0102eatingworms,macro-expression,1,56,76,1072,20,-1
16,./CAS(ME)2_longVideoFaceCropped/longVideoFaceCropped/s33/33_0102eatingworms,macro-expression,1,108,130,1072,22,-1
16,./CAS(ME)2_longVideoFaceCropped/longVideoFaceCropped/s33/33_0402beatingpregnantwoman,macro-expression,1,3682,3699,4374,17,5
16,./CAS(ME)2_longVideoFaceCropped/longVideoFaceCropped/s33/33_0402beatingpregnantwoman,macro-expression,1,4328,4356,4374,28,-1
17,./CAS(ME)2_longVideoFaceCropped/longVideoFaceCropped/s34/34_0401girlcrashing,macro-expression,1,1763,1787,3715,24,-1
17,./CAS(ME)2_longVideoFaceCropped/longVideoFaceCropped/s34/34_0402beatingpregnantwoman,macro-expression,1,2170,2205,4371,35,-1
17,./CAS(ME)2_longVideoFaceCropped/longVideoFaceCropped/s34/34_0503unnyfarting,macro-expression,1,990,1042,2811,52,4
18,./CAS(ME)2_longVideoFaceCropped/longVideoFaceCropped/s35/35_0102eatingworms,micro-expression,2,100,113,1081,13,2
18,./CAS(ME)2_longVideoFaceCropped/longVideoFaceCropped/s35/35_0102eatingworms,micro-expression,2,363,371,1081,8,3
19,./CAS(ME)2_longVideoFaceCropped/longVideoFaceCropped/s36/36_0401girlcrashing,macro-expression,1,106,145,3720,39,-1
19,./CAS(ME)2_longVideoFaceCropped/longVideoFaceCropped/s36/36_0505funnyinnovations,macro-expression,1,348,393,2306,45,4
19,./CAS(ME)2_longVideoFaceCropped/longVideoFaceCropped/s36/36_0505funnyinnovations,macro-expression,1,566,602,2306,36,4
19,./CAS(ME)2_longVideoFaceCropped/longVideoFaceCropped/s36/36_0505funnyinnovations,macro-expression,1,1074,1095,2306,21,4
20,./CAS(ME)2_longVideoFaceCropped/longVideoFaceCropped/s37/37_0101disgustingteeth,macro-expression,1,1289,1310,2052,21,-1
20,./CAS(ME)2_longVideoFaceCropped/longVideoFaceCropped/s37/37_0402beatingpregnantwoman,macro-expression,1,2783,2810,4371,27,-1
20,./CAS(ME)2_longVideoFaceCropped/longVideoFaceCropped/s37/37_0402beatingpregnantwoman,macro-expression,1,3045,3066,4371,21,5
20,./CAS(ME)2_longVideoFaceCropped/longVideoFaceCropped/s37/37_0402beatingpregnantwoman,macro-expression,1,3176,3200,4371,24,5
20,./CAS(ME)2_longVideoFaceCropped/longVideoFaceCropped/s37/37_0402beatingpregnantwoman,macro-expression,1,3397,3413,4371,16,-1
20,./CAS(ME)2_longVideoFaceCropped/longVideoFaceCropped/s37/37_0402beatingpregnantwoman,micro-expression,2,3502,3514,4371,12,2
20,./CAS(ME)2_longVideoFaceCropped/longVideoFaceCropped/s37/37_0502funnyerrors,macro-expression,1,851,875,2270,24,4
20,./CAS(ME)2_longVideoFaceCropped/longVideoFaceCropped/s37/37_0502funnyerrors,macro-expression,1,1858,1888,2270,30,4
20,./CAS(ME)2_longVideoFaceCropped/longVideoFaceCropped/s37/37_0505funnyinnovations,macro-expression,1,414,443,2306,29,4
20,./CAS(ME)2_longVideoFaceCropped/longVideoFaceCropped/s37/37_0505funnyinnovations,macro-expression,1,1167,1202,2306,35,4
20,./CAS(ME)2_longVideoFaceCropped/longVideoFaceCropped/s37/37_0505funnyinnovations,macro-expression,1,1468,1509,2306,41,4
20,./CAS(ME)2_longVideoFaceCropped/longVideoFaceCropped/s37/37_0505funnyinnovations,macro-expression,1,1511,1541,2306,30,4
20,./CAS(ME)2_longVideoFaceCropped/longVideoFaceCropped/s37/37_0505funnyinnovations,macro-expression,1,1941,1974,2306,33,4
20,./CAS(ME)2_longVideoFaceCropped/longVideoFaceCropped/s37/37_0505funnyinnovations,macro-expression,1,2229,2269,2306,40,4
20,./CAS(ME)2_longVideoFaceCropped/longVideoFaceCropped/s37/37_0507climbingthewall,macro-expression,1,846,881,3264,35,4
20,./CAS(ME)2_longVideoFaceCropped/longVideoFaceCropped/s37/37_0507climbingthewall,macro-expression,1,1571,1680,3264,109,4
20,./CAS(ME)2_longVideoFaceCropped/longVideoFaceCropped/s37/37_0507climbingthewall,macro-expression,1,1751,1782,3264,31,4
20,./CAS(ME)2_longVideoFaceCropped/longVideoFaceCropped/s37/37_0507climbingthewall,macro-expression,1,2020,2074,3264,54,4
20,./CAS(ME)2_longVideoFaceCropped/longVideoFaceCropped/s37/37_0507climbingthewall,macro-expression,1,2341,2400,3264,59,4
20,./CAS(ME)2_longVideoFaceCropped/longVideoFaceCropped/s37/37_0507climbingthewall,macro-expression,1,2688,2752,3264,64,4
20,./CAS(ME)2_longVideoFaceCropped/longVideoFaceCropped/s37/37_0508funnydunkey,macro-expression,1,233,255,660,22,4
20,./CAS(ME)2_longVideoFaceCropped/longVideoFaceCropped/s37/37_0508funnydunkey,macro-expression,1,322,353,660,31,4
20,./CAS(ME)2_longVideoFaceCropped/longVideoFaceCropped/s37/37_0508funnydunkey,micro-expression,2,418,430,660,12,1
21,./CAS(ME)2_longVideoFaceCropped/longVideoFaceCropped/s38/38_0502funnyerrors,macro-expression,1,329,362,2277,33,4
21,./CAS(ME)2_longVideoFaceCropped/longVideoFaceCropped/s38/38_0502funnyerrors,macro-expression,1,878,922,2277,44,4
21,./CAS(ME)2_longVideoFaceCropped/longVideoFaceCropped/s38/38_0502funnyerrors,macro-expression,1,962,981,2277,19,4
21,./CAS(ME)2_longVideoFaceCropped/longVideoFaceCropped/s38/38_0502funnyerrors,macro-expression,1,1189,1217,2277,28,4
21,./CAS(ME)2_longVideoFaceCropped/longVideoFaceCropped/s38/38_0502funnyerrors,macro-expression,1,1782,1841,2277,59,4
21,./CAS(ME)2_longVideoFaceCropped/longVideoFaceCropped/s38/38_0502funnyerrors,macro-expression,1,1869,1902,2277,33,4
21,./CAS(ME)2_longVideoFaceCropped/longVideoFaceCropped/s38/38_0507climbingthewall,macro-expression,1,1242,1263,3264,21,4
21,./CAS(ME)2_longVideoFaceCropped/longVideoFaceCropped/s38/38_0507climbingthewall,macro-expression,1,1377,1422,3264,45,4
21,./CAS(ME)2_longVideoFaceCropped/longVideoFaceCropped/s38/38_0507climbingthewall,macro-expression,1,1664,1703,3264,39,4
21,./CAS(ME)2_longVideoFaceCropped/longVideoFaceCropped/s38/38_0507climbingthewall,macro-expression,1,1775,1809,3264,34,4
21,./CAS(ME)2_longVideoFaceCropped/longVideoFaceCropped/s38/38_0507climbingthewall,macro-expression,1,1870,1911,3264,41,4
21,./CAS(ME)2_longVideoFaceCropped/longVideoFaceCropped/s38/38_0507climbingthewall,micro-expression,2,2232,2247,3264,15,1
22,./CAS(ME)2_longVideoFaceCropped/longVideoFaceCropped/s40/40_0401girlcrashing,macro-expression,1,392,415,3714,23,5
22,./CAS(ME)2_longVideoFaceCropped/longVideoFaceCropped/s40/40_0401girlcrashing,macro-expression,1,592,613,3714,21,5
22,./CAS(ME)2_longVideoFaceCropped/longVideoFaceCropped/s40/40_0502funnyerrors,macro-expression,1,601,633,2275,32,4
22,./CAS(ME)2_longVideoFaceCropped/longVideoFaceCropped/s40/40_0502funnyerrors,macro-expression,1,1598,1633,2275,35,4
22,./CAS(ME)2_longVideoFaceCropped/longVideoFaceCropped/s40/40_0503unnyfarting,macro-expression,1,2692,2727,2814,35,4
